آبشت	آبش
آجد	آج
آجست	
آجید	آجین
آخت	آز
آراماند	آرامان
آرامانید	آرامان
آرامید	آرام
آرمید	آرام
آزارد	آزار
آزد	آز
آزرد	آزار
آزما‌یید	آزما‌ی
آزند	آزن
آشامید	آشام
آشفت	آشوب
آشوباند	آشوبان
آشوبید	آشوب
آشورد	آشور
آشوفت	آشوب
آشکوخید	آشکوخ
آشیبید	آشیب
آغارد	آغار
آغارید	آغار
آغازید	آغاز
آغالاند	آغالان
آغالید	آغال
آغشت	آغار
آغند	آغن
آغوشید	آغوش
آفرید	آفرین
آفرین	آفرید
آفندید	آفند
آلفت	آلف
آمارد	آمار
آماسید	آماس
آماهید	آماه
آمخت	آمز
آمرزید	آمرز
آموخت	آموز
آموزاند	آموزان
آموزید	آموز
آمیخت	آمیز
آمیغد	آمیز
آهخت	آهز
آهنجید	آهنج
آهیخت	آهنج
آهیخت	آهیز
آورد	آر
آورد	آور
آویخت	آویز
آچارد	آچاردن
آژد	آژین
آژند	آژن
آژید	آژ
آکند	آکن
آگاهاند	آگاهان
آگاهانید	آگاهان
آگاهید	آگاه
آگشت	آگرد
آگند	آگن
اخت	از
ارزید	ارز
ارزید	لرز
استاند	استان
استانید	استان
استد	استان
استرد	استر
استید	است
اسپارد	اسپار
اسپرد	اسپر
اشناخت	اشناس
اشپیخت	اشپیز
اشکرد	اشکر
اشکست	اشکن
افتاد	افت
افتید	افت
افراخت	افراز
افرازید	افراز
افراشت	افراز
افرندید	افرند
افروخت	افروز
افروزاند	افروزان
افروزید	افروز
افسرد	افسر
افشارد	افشار
افشاند	افشان
افشرد	افشر
افژولید	افژول
افکند	افکن
الفاخت	الفاز
الفخت	الفز
الفغد	
الفنجید	الفنج
انبازید	انباز
انباشت	انبار
انباشت	انباز
انبوسید	انبوس
انجامید	انجام
انجید	انج
انجیرد	انجیر
انداخت	انداز
اندخسید	اندخس
اندرآمد	آندرآ
اندرآمد	آندرآی
اندرآورد	آندرآور
اندرخورد	اندرخور
اندرشد	اندرشو
اندرماند	اندرمان
اندرنهاد	اندرنه
اندرنوشت	اندرنویس
اندرچمید	اندرچم
اندرکرد	اندرکن
اندرکشید	اندرکش
اندرگذاشت	اندرگذار
اندرگذشت	اندرگذر
اندرگرفت	اندرگیر
اندریافت	اندریاب
اندوخت	اندوز
اندوزید	اندوز
اندیشید	اندیش
انگارد	انگار
انگاشت	انگار
انگیخت	انگیز
انگیزاند	انگیزان
اوبارد	اوبار
اوباشت	اوبار
اوبرد	اوبر
اورندید	اورند
اوشاند	اوشان
اوفتاد	اوفت
اوفتید	اوفت
اوژند	اوژن
اوکند	اوکن
اوگند	اوگن
ایستاد	ایست
ایستاند	ایستان
ایستید	ایست
باخت	باز
باراند	باران
بارید	بار
بازآفرید	بازآفرین
بازآمد	بازآ
بازآموخت	بازآموز
بازآورد	بازآور
بازایستاد	بازایست
بازتابید	بازتاب
بازخواست	بازخواه
بازخواند	بازخوان
بازخوراند	بازخوران
بازداد	بازده
بازداشت	بازدار
بازرساند	بازرسان
بازرسانید	بازرسان
باززد	باززن
بازستاند	بازستان
بازشمارد	بازشمار
بازشمرد	بازشمر
بازشناخت	بازشناس
بازشناساند	بازشناسان
بازفرستاد	بازفرست
بازماند	بازمان
بازنشست	بازنشین
بازنمایاند	بازنمایان
بازنهاد	بازنه
بازنگریست	بازنگر
بازپرسید	بازپرس
بازگذارد	بازگذار
بازگذاشت	بازگذار
بازگرداند	بازگردان
بازگردانید	بازگردان
بازگردید	بازگرد
بازگرفت	بازگیر
بازگشت	بازگرد
بازیافت	بازیاب
بازید	باز
باشید	باش
بافت	باف
بافید	باف
بالید	بال
باوراند	باوران
بایست	باید
بخسانید	بخسان
بخسید	بخس
بخشید	بخش
بدن	
برآشفت	برآشوب
برآغالید	برآغال
برآمد	برآ
برآمد	برآی
برآمیخت	برآمیز
برآهیخت	برآهیز
برآورد	برآور
برازید	براز
برافتاد	برافت
برافراخت	برافراز
برافراشت	برافراز
برافروخت	برافروز
برافشاند	برافشان
برافکند	برافکن
برانداخت	برانداز
برانگیخت	برانگیز
برانگیزاند	برانگیزان
براویخت	براویز
بربرد	بربر
بربست	بربند
برتاباند	برتابان
برتابید	برتاب
برتافت	برتاب
برتاوید	برتاو
برتنید	برتن
برتپید	برتپ
برجهید	برجه
برخاست	برخیز
برخواست	برخواه
برخورد	برخور
برخیزاند	برخیزان
برد	بر
برداد	برده
برداشت	بردار
بردفسانید	بردفسان
بردفسید	بردفس
بردماند	بردمان
بردمید	بردم
بردوخت	بردوز
بردید	بربین
بررسید	بررس
بررفت	بررو
برزد	برزن
برزید	برز
برساخت	برساز
برسخت	برسز
برسکیزید	برسکیز
برشت	برش
برشد	برشو
برشمارد	برشمار
برشمرد	برشمر
برشکست	برشکن
برغلنبید	برغلنب
برفروخت	برفروز
برفشاند	برفشان
برماسید	برماس
برمالید	برمال
برمچید	برمچ
برنشاند	برنشان
برنشانید	برنشان
برنشست	برنشین
برنهاد	برنه
برنوردید	برنورد
برنوشت	برنویس
برهیخت	برهیز
برچد	برچن
برچید	برچین
برکت‌د	برکن
برکرد	برکن
برکشید	برکش
برکند	برکن
برگاشت	برگرد
برگذاشت	برگذار
برگذشت	برگذر
برگرداند	برگردان
برگردانید	برگردان
برگردید	برگرد
برگرفت	برگیر
برگزید	برگزین
برگشت	برگرد
برگمارد	برگمار
برگمارید	برگمار
برگماشت	برگمار
برید	بر
بزید	بز
بسارد	بسار
بست	بند
بسود	بساو
بسیجید	بسیج
بسید	بس
بسیچید	بسیچ
بشلید	بشل
بشولاند	بشولان
بشولید	بشول
بشکلید	بشکل
بلعید	بلع
بود	است
بود	باش
بود	بو
بود	هست
بوسید	بوس
بیخت	بیز
بیزید	بیز
تاباند	تابان
تابید	تاب
تابید	تاو
تاخت	تاز
تاراند	تاران
تازاند	تازان
تازید	تاز
تاسانید	تاسان
تاسید	تاس
تافت	تاب
تاواند	تاوان
تاوست	تاو
تاوید	تاو
تبسید	تبس
تخشید	تخش
تراببید	تراب
ترازید	تراز
تراشاند	تراشان
تراشید	تراش
تراواند	تراوان
تراوید	تراو
ترساند	ترسان
ترسانید	ترسان
ترسید	ترس
ترشاند	ترشان
ترشانید	ترشان
ترشید	ترش
ترقید	ترق
ترنجید	ترنج
ترنگید	ترنگ
ترکاند	ترکان
ترکانید	ترکان
ترکید	ترک
تسباند	تسبان
تسبانید	تسبان
تفت	تاب
تفتانید	تفتان
تفتید	تفت
تفساند	تفسان
تفسانید	تفسان
تفسید	تفس
تفید	تف
تلابید	تلاب
تلاوید	تلاو
تلخید	تلخ
تلکید	تلک
تمرگید	تمرگ
تمید	تم
تنجاند	تنجان
تنجید	تنج
تندند	تن
تندید	تند
تنود	تن
تنید	تن
تواند	تاوان
توانست	توان
توخت	توز
توزید	توز
توفید	توف
توپید	توپ
تپاند	تپان
تپانید	تپان
تپید	تپ
تکاند	تکان
تکانید	تکان
تکید	تک
تیزید	تیز
تیغید	تیغ
جخید	جخ
جرنگید	جرنگ
جزاند	جزان
جست	جه
جنباند	جنبان
جنبید	جنب
جنگید	جنگ
جهاند	جهان
جهید	جه
جوشاند	جوشان
جوشید	جوش
جويد	جو
جوید	جو
خاراند	خاران
خارید	خار
خاست	خاست
خاست	خیز
خاموشید	خاموش
خاوید	خاو
خجید	خج
خراشاند	خراشان
خراشید	خراش
خرامید	خرام
خروشید	خروش
خرید	خر
خزید	خز
خسانید	خسان
خسباند	خسبان
خسبید	خسب
خست	خس
خشکاند	خشکان
خشکید	خشک
خفت	خسب
خفت	خواب
خفتانید	خفتان
خفتید	خفت
خفید	خف
خلاند	خلان
خلید	خل
خماند	خمان
خمید	خم
خنداند	خندان
خندانید	خندان
خندید	خند
خنید	خن
خواباند	خوابان
خوابانید	خوابان
خوابید	خواب
خوارد	خوار
خواست	خواه
خواند	خوان
خوراند	خوران
خورد	خور
خوشانید	خوشان
خوفت	خوسب
خیزاند	خیزان
خیزید	خیز
خیساند	خیسان
خیسید	خیس
داخید	داخ
داد	ده
داشت	دار
دانست	دان
درآمد	درآ
درآموخت	درآموز
درآمیخت	درآمیز
درآورد	درآر
درآورد	درآور
درآویخت	درآویز
درافتاد	درافت
درافشاند	درافشان
درافکند	درافکن
دراند	دران
درانداخت	درانداز
درباخت	درباز
دربافت	درباف
دربرد	دربر
دربست	دربند
درخشانید	درخشان
درخشید	درخش
درخواست	درخواه
درداد	درده
دردمید	دردم
دررسید	دررس
دررفت	دررو
درساخت	درساز
درغلتید	درغلت
درفشید	درفش
درماند	درمان
درنشاند	درنشان
درنهفت	درنهنب
درنوردید	درنورد
درنوشت	درنویس
درپوشید	درپوش
درپیوست	درپیوند
درکرد	درکن
درکشید	درکش
درکند	درکن
درگذاشت	درگذار
درگذشت	درگذر
درگرفت	درگیر
درگیرانید	درگیران
دریافت	دریاب
درید	در
دزدید	دزد
دمید	دم
دنید	دن
دواند	دوان
دوخت	دوز
دوساند	دوسان
دوسید	دوس
دوشاند	دوشان
دوشید	دوش
دوید	دو
دید	بین
راند	ران
ربانید	ربان
رخشید	رخش
رخید	رخ
رزید	رز
رساند	رسان
رسانید	رسان
رست	ره
رسید	رس
رشت	ریس
رفت	رو
رفت	روب
رقصاند	رقصان
رقصید	رقص
رماند	رمان
رمبید	رمب
رمید	رمید
رنجاند	رنجان
رنجید	رنج
رندید	رند
رهاند	رهان
رهانید	رهان
رهید	ره
روبید	روب
روفت	
رویاند	رویان
ریخت	ریز
رید	رین
ریست	ریس
ریسید	ریس
زد	زن
سابید	ساب
ساخت	ساز
ستاند	ستان
ستد	ستان
سترد	ستر
ستیزید	ستیز
سفت	سنب
سنبید	سنب
سنجید	سنج
سهمید	سهم
سوخت	سوز
سوزاند	سوزان
سپارد	سپار
سپرد	سپار
سپرد	سپر
سپوخت	سپوز
سپوزاند	سپوزان
شاشید	شاش
شایست	شاید
شتافت	شتاب
شد	شو
شست	شور
شمارد	شمار
شمرد	شمار
شمرد	شمر
شناخت	شناس
شناساند	شناسان
شنفت	شنو
شنید	شنو
شوراند	شوران
شورید	شور
شکافت	شکاف
شکرد	شکر
شکست	شکن
شکفت	شکف
شیبید	شیب
طلبید	طلب
طپید	طپ
غرید	غر
غلتاند	غلتان
غلتانید	غلتان
غلتید	غلت
غلطاند	غلطان
غلطانید	غلطان
غلطید	غلط
فراخت	فراز
فراخواست	فراخواه
فراخواند	فراخوان
فراداشت	فرادار
فرارسید	فرارس
فراگرفت	فراگیر
فرستاد	فرست
فرهیخت	فرهیز
فروآمد	فروآ
فروآورد	فروآور
فروافتاد	فروافت
فروافکند	فروافکن
فروبرد	فروبر
فروبست	فروبند
فروخت	فروز
فروخت	فروش
فروخفت	فروخواب
فروخواست	فروخواه
فروخورد	فروخور
فروداد	فروده
فرودوخت	فرودوز
فرورفت	فرورو
فروریخت	فروریز
فروشکست	فروشکن
فروفرستاد	فروفرست
فروماند	فرومان
فرونشاند	فرونشان
فرونشانید	فرونشان
فرونشست	فرونشین
فرونهاد	فرونه
فروپاشاند	فروپاشان
فروپاشید	فروپاش
فروچکید	فروچک
فروکرد	فروکن
فروکشید	فروکش
فروکوبید	فروکوب
فروکوفت	فروکوب
فروگذارد	فروگذار
فروگذاشت	فروگذار
فروگرفت	فروگیر
فریفت	فریب
فشاند	فشان
فشرد	فشار
فهماند	فهمان
فهمید	فهم
قاپید	قاپ
قبولاند	قبولان
لافید	لاف
لرزاند	لرزان
لرزید	لرز
لغزاند	لغزان
لغزید	لغز
لمباند	لمبان
لمید	لم
لنگید	لنگ
لولید	لول
لیسید	لیس
مالید	مال
ماند	مان
مانست	مان
مانید	مان
مرد	میر
مکید	مک
میخت	میز
میزید	میز
نازید	ناز
نالید	نال
نامید	نام
نشاند	نشان
نشست	نشین
نمایاند	نمایان
نهاد	نه
نهفت	نهنب
نواخت	نواز
نوردید	نورد
نوشاند	نوشان
نوشت	نویس
نوشید	نوش
نکوهید	نکوه
نگار	نگاشت
نگاشت	نگار
نگریست	نگر
هراسید	هراس
هشت	هل
هیخت	هیز
واایستاد	واایست
وابست	وابند
واخواست	واخواه
واداد	واده
واداشت	وادار
وادید	وابین
وارست	واره
وارفت	وارو
واریخت	واریز
وازد	وازن
واشد	واشو
واماند	وامان
وانشست	وانشین
وانهاد	وانه
وانگریست	وانگر
واچید	واچین
واکرد	واکن
واکوفت	واکوب
واگذارد	واگذار
واگذاشت	واگذار
واگردید	واگرد
واگرفت	واگیر
ورآمد	ورآ
ورآورد	ورآر
ورآورد	ورآور
ورافتاد	ورافت
ورانداخت	ورانداز
ورخواست	ورخواه
ورداشت	وردار
وررفت	وررو
ورزد	ورزن
ورزید	ورز
ورشکست	ورشکن
ورمالید	ورمال
ورچید	ورچین
وزاند	وزان
وزید	وز
وگفت	واگوی
پاشاند	پاشان
پاشانید	پاشان
پاشید	پاش
پالانید	پالان
پالید	پال
پاچید	پاچ
پاکید	پاک
پخت	پز
پذرفت	پذر
پذیراند	پذیران
پذیرانید	پذیران
پذیرفت	پذیر
پراند	پران
پرانید	پران
پراکند	پراکن
پراکنید	پراکن
پرتافت	پرتاب
پرداخت	پرداز
پرستید	پرست
پرسید	پرس
پرهیخت	پرهیز
پرهیزید	پرهیز
پرواسید	پرواس
پروراند	پروران
پرورانید	پروران
پرورد	پرور
پرورید	پرور
پرچید	پرچین
پرید	پر
پریشید	پریش
پزاند	پزان
پسابید	پساب
پساوید	پساو
پسندید	پسند
پلاسید	پلاس
پلکید	پلک
پناهید	پناه
پندارید	پندار
پنداشت	پندار
پوساند	پوسان
پوسانید	پوسان
پوسید	پوس
پوشاند	پوشان
پوشانید	پوشان
پوشید	پوش
پژمرد	پژمر
پژولید	پژول
پژوهید	پژوه
پکید	پک
پیخت	پیز
پیوست	پیوند
پیونداند	پیوندان
پیچاند	پیچان
پیچانید	پیچان
پیچید	پیچ
چاهید	چاه
چاوید	چاو
چایاند	چایان
چخید	چخ
چراند	چران
چرباند	چربان
چربید	چرب
چرخاند	چرخان
چرخید	چرخ
چروکید	چروک
چرید	چر
چزاند	چزان
چسباند	چسبان
چسبید	چسب
چسید	چس
چشاند	چشان
چشید	چش
چغید	چغ
چفسید	چفس
چلاند	چل
چلانید	چلان
چماند	چمان
چمید	چم
چپاند	چپان
چپید	چپ
چکاند	چکان
چکید	چک
چید	چین
کاست	کاه
کاشت	کار
کاشت	کاه
کافت	کاف
کاهید	کاه
کاوید	کاو
کراشید	کراش
کرد	کن
کشاند	کشان
کشانید	کشان
کشت	کار
کشت	کش
کشفت	کشوف
کشید	کش
کند	کن
کوبید	کوب
کوشید	کوش
کوفت	کوب
کوچید	کوچ
گداخت	گداز
گذارد	گذار
گذاشت	گذار
گذراند	گذران
گذشت	گذر
گرداند	گردان
گردانید	گردان
گردید	گرد
گرفت	گیر
گریاند	گریان
گریخت	گریز
گزارد	گزار
گزید	گز
گزید	گزین
گستراند	گستران
گسترد	گستر
گسست	گسل
گسیخت	گسل
گشا	گشود
گشت	گرد
گمارد	گمار
گماشت	گمار
گنجاند	گنجان
گنجانید	گنجان
گنجید	گنج
گندید	گند
یاخت	یاز
یافت	یاب
یوزید	یوز
آمد	آ
آمد	آی
آراست	آرا
آراست	آرای
آزما‌یید	آزما‌
آزما‌یید	آزما‌ی
آزمود	آزما
آزمود	آزمای
آسایید	آسا
آسایید	آسای
آسود	آسا
آسود	آسای
آلایید	آلا
آلایید	آلای
آلود	آلا
آلود	آلای
آماد	آما
آماد	آمای
آمود	آما
آمود	آمای
اشنود	اشنو
اشنود	اشنوی
اشنید	اشنو
اشنید	اشنوی
افزایید	افزا
افزایید	افزای
افزود	افزا
افزود	افزای
انبود	انبا
انبود	انبای
انبویید	انبو
انبویید	انبوی
اندایید	اندا
اندایید	اندای
اندود	اندا
اندود	اندای
بازجست	بازجو
بازجست	بازجوی
بازگشود	بازگشا
بازگشود	بازگشای
بازگفت	بازگو
بازگفت	بازگوی
بایست	با
بایست	بای
بتایید	بتا
بتایید	بتای
بخشود	بخشا
بخشود	بخشای
برآسود	برآسا
برآسود	برآسای
برافزودن	برافزا
برافزودن	برافزای
برجست	برجو
برجست	برجوی
بررست	بررو
بررست	برروی
برفتاد	برفتا
برفتاد	برفتای
برفزود	برفزا
برفزود	برفزای
برهود	برها
برهود	برهای
برگرایید	برگرا
برگرایید	برگرای
برگشاد	برگشا
برگشاد	برگشای
برگشود	برگشا
برگشود	برگشای
بویید	بو
بویید	بوی
جست	جو
جست	جوی
جفت	جو
جفت	جوی
خایید	خا
خایید	خای
خسود	خسا
خسود	خسای
خشود	خشا
خشود	خشای
درآیید	درآ
درآیید	درآی
درربود	درربا
درربود	درربای
درنمود	درنما
درنمود	درنمای
درود	درا
درود	درای
دروید	درو
دروید	دروی
ربایید	ربا
ربایید	ربای
ربود	ربا
ربود	ربای
رست	رو
رست	روی
رویید	رو
رویید	روی
زاد	زا
زاد	زای
زایید	زا
زایید	زای
زدود	زدا
زدود	زدای
زیست	زی
زیست	زیی
ستود	ستا
ستود	ستای
سرایید	سرا
سرایید	سرای
سرود	سرا
سرود	سرای
سزید	سزا
سزید	سزای
سود	سا
سود	سای
شایست	شا
شایست	شای
شخود	شخا
شخود	شخای
شست	شو
شست	شوی
غنود	غنو
غنود	غنوی
فرانمود	فرانما
فرانمود	فرانمای
فرسود	فرسا
فرسود	فرسای
فرمود	فرما
فرمود	فرمای
فرونمود	فرونما
فرونمود	فرونمای
فزود	فزا
فزود	فزای
فلخود	فلخو
فلخود	فلخوی
مویید	مو
مویید	موی
نمود	نما
نمود	نمای
وانمود	وانما
وانمود	وانمای
واگفت	واگو
واگفت	واگوی
ویراست	ویرا
ویراست	ویرای
پالایید	پالا
پالایید	پالای
پالود	پالا
پالود	پالای
پایست	پا
پایست	پای
پایید	پا
پایید	پای
پسود	پسا
پسود	پسای
پویید	پو
پویید	پوی
پیراست	پیرا
پیراست	پیرای
پیرایید	پیرا
پیرایید	پیرای
پیمود	پیما
پیمود	پیمای
چایید	چا
چایید	چای
چفت	چو
چفت	چوی
گایید	گا
گایید	گای
گرایید	گرا
گرایید	گرای
گروید	گرا
گروید	گرای
گروید	گرو
گروید	گروی
گریست	گری
گریست	گریی
گشاد	گشا
گشاد	گشای
گشود	گشا
گشود	گشای
گفت	گو
گفت	گوی