آخر	اواخر
آزاده	آزادگان
آزهار	ازاهیر
آفت	آفات
آلت	آلات
آلف	الاف
آمرزیده	آمرزیدگان
آموزنده	آموزندگان
آن	آنات
آن	اوان
آنسة	اوانس
آنسه	اوانس
آیت	آیات
آیه	آیات
اب	آبا
اب	آباء
ابخره	بخار
ابریق	اباریق
ابعد	اباعد
ابله	بلها
ابلیس	ابالسه
ابن	ابنا
ابن	ابناء
ابن	بنون
ابن	بنی
اثر	آثار
اثم	آثام
اجر	اجور
اجل	آجال
اجنبی	اجانب
احتجاج	احتجاجات
احد	آحاد
احساس	احساسات
احفار	احافیر
احمق	حمقا
احمق	حمقاء
اخ	اخوان
اخ	اخوه
اخت	اخوات
اخراج	اخراجات
اخریٰ	اخریات
ادات	ادوات
ادویه	ادویه‌جات
ادیب	ادبا
ادیب	ادباء
اربعین	اربعینات
ارتباط	ارتباطات
ارض	اراضی
ارض	ارضین
ارقم	اراقم
ارمل	ارامل
ارمنی	ارامنه
ارنب	ارانب
اریکه	ارایک
ازمه	زمان
ازهار	ازاهیر
استاد	اساتید
استعاره	استعارات
اسد	آساد
اسد	اسود
اسطوانه	اساطین
اسطور	اساطیر
اسطوره	اساطیر
اسفل	اسافل
اسقف	اساقفه
اسلوب	اسالیب
اسم	اسامی
اسم	اسما
اسم	اسماء
اسناد	اسانید
اسیر	اسر
اسیر	اسرا
اسیر	اسراء
اشاره	اشارات
اشاره	اشارت
اشراقی	اشراقیون
اشکانی	اشکانیان
اصبع	اصابع
اصر	آصار
اصطلاح	اصطلاحات
اصغر	اصاغر
اصل	اصول
اصلاح	اصلاحات
اصم	صم
اصیل	آصال
اضافه	اضافات
اضلوله	اضالیل
اطلاع	اطلاعات
اطیب	اطایب
اظفور	اظافر
اظهار	اظهارات
اعتدالی	اعتدالیون
اعتزالی	اعتزالیون
اعتصابی	اعتصابیون
اعجم	اعاجم
اعجوبه	اعاجیب
اعرابی	اعراب
اعلی	اعالی
اغروده	اغارید
اغلوطه	اغالیط
اغنیه	اغانی
افعی	افاعی
افغان	افاغنه
افق	آفاق
افواه	افاویه
اقرار	اقاریر
اقرب	اقارب
اقلیم	اقالیم
اقنوم	اقانیم
اقوال	اقاویل
الاهیه	الاهیات
الحاق	الحاقات
الحاکم	الحکام
الف	آلاف
الف	الوف
القا	القا
القاء	القا
القائات	القا
الم	آلام
اله	آلهه
الکبیر	الکبار
ام	امات
ام	امهات
امارت	امارات
امام	ائمه
امام	ایمه
امام	امامان
امانت	امانات
امة	اما
امت	امم
امتیاز	امتیازات
امجد	اماجد
امر	امور
امر	اوامر
امراد	امارده
امرد	امارد
امل	آمال
امه	اما
امکان	امکانات
امیر	امرا
امیر	امراء
امین	امنا
امین	امناء
امین	امنای
انا	آنیه
انام	آنام
انبوبه	انابیب
انتخاب	انتخاب‌کنندگان
انثی	اناث
انجیل	اناجیل
انحصار	انحصارات
انشودة	اناشید
انشوده	اناشید
انف	انوف
انقلابی	انقلابیون
انملة	انامل
انمله	انامل
اهجوة	اهاجی
اهجوه	اهاجی
اهل	اهالی
اول	اوا
اول	اوائل
اول	اوایل
اولویت	اولویات
اولیة	اولیات
اولیه	اولیات
اُضلولة	اضالیل
اُغرودة	اغارید
اُغلوطة	اغالیط
اُکرَة	اکر
اِنا	آنیه
اکار	اکره
اکدش	اکادشه
اکذوبه	اکاذیب
اکرم	اکارم
اکره	اکر
ایالت	ایالات
ایراد	ایرادات
ایل	ایلات
ایل	ایلیات
ایم	ایامی
ایه	ایات
ایوان	ایاوین
بئر	آبار
باب	ابواب
بارد	بوارد
بارف	بوارق
بازمانده	بازماندگان
باطل	اباطیل
باطن	بواطن
باغ	باغات
باغی	بغات
باقی	باقیات
باقیات	باقی
بانو	بانوان
بثر	بثور
بثر	بثورات
بثره	بثور
بجره	بجر
بحث	ابحاث
بحر	بحار
بحر	بحور
بخاره	ابخره
بخور	ابخره
بخیل	بخلا
بد	بدود
بدر	بدور
بدل	بدلا
بدن	ابدان
بدیعه	بدائع
بدیعه	بدایع
بدیهی	بدیهیات
بذر	بذور
بر	ابرار
برات	بروات
برثن	براثن
برج	ابراج
برج	بروج
برجمه	براجم
برده	بردگان
برذون	براذین
برزخ	برازخ
برطیل	براطیل
برق	بروق
برقع	براقع
برهان	براهین
برهمن	براهمه
برکت	برکات
برگزیده	برگزیدگان
بریت	بریات
بریه	برایا
بزرگوار	بزرگواران
بستان	بساتین
بسیط	بسایط
بشارت	بشایر
بشاره	بشایر
بصر	ابصار
بصیر	بصرا
بصیرت	بصایر
بصیره	بصایر
بطانه	بطاین
بطریق	بطارقه
بطل	ابطال
بطن	بطون
بطیحه	بطایح
بعث	بعوث
بعد	ابعاد
بعر	ابعار
بعض	ابعاض
بعل	بعول
بغض	ابغاض
بغل	بغال
بقع	بقعه
بقعه	بقاع
بقیه	بقایا
بلا	بلایا
بلد	بلاد
بلد	بلدان
بلیخ	بلغا
بلیخ	بلغاء
بلیغ	بلغا
بلیه	بلایا
بلیه	بلیات
بنا	ابنیه
بناء	ابنیه
بنت	بنات
بندر	بنادر
بندق	بنادق
بنده	بتدگان
بنده	بندگان
بنکام	بنکامات
بهیمه	بهائم
بهیمه	بهایم
بوارد	بارد
بول	ابوال
بَثر	بثور
بَثر	بثورات
بَخیل	بخلا
بَدر	بدور
بَرزَخ	برازخ
بَسیط	بسایط
بَصیر	بصرا
بَصیرَة	بصایر
بَطیحَة	بطایح
بُجرَة	بجر
بُد	بدود
بُرثُن	براثن
بُرجُمَة	براجم
بُرقَع	براقع
بِدَل	بدلا
بِرطیل	براطیل
بِشارَة	بشایر
بِطانَة	بطاین
بکر	ابکار
بکیم	بکمان
بیان	بیانات
بیت	ابیات
بیت	بیوت
بیت	بیوتات
بینه	بینات
بیگانه	بیگانگان
تابع	اتباع
تابع	توابع
تابعین	تابع
تابل	توابل
تابوت	توابیت
تابین	توابین
تاجر	تاجار
تاجر	تجار
تاریخ	تواریخ
تبدل	تبدلات
تبشیر	تباشیر
تبع	اتباع
تبعه	اتباع
تجربه	تجارب
تجربه	تجربیات
تجفاف	تجافیف
تجلی	تجلیات
تجویف	تجاویف
تحریک	تحریکات
تحسین	تحاسین
تحفه	تحف
تحقیق	تحقیقات
تحویل	تحاویل
تحیة	تحایا
تحیت	تحیات
تحیه	تحایا
تخریب	تخاریب
تخلیط	تخالیت
تخم	تخوم
تدارک	تدارکات
تدبیر	تدابیر
تذکره	تذاکر
ترجمه	تراجم
ترسیم	ترسیمات
ترشح	ترشحات
ترشی	ترشیجات
ترقی	ترقیات
ترک	اتراک
ترکمان	تراکمه
ترکیب	ترکیبات
تزویق	تزاویق
تسبیح	تسبیحات
تسعیرنامچه	تسعیرنامجات
تسهیل	تسهیلات
تسییر	تساییر
تشبیه	تشبیهات
تشنج	تشنجات
تصریف	تصاریف
تصنیف	تصانیف
تصور	تصورات
تصویر	تصاویر
تضریس	تضاریس
تعارف	تعارفات
تعب	اتعاب
تعبیر	تعابیر
تعریج	تعاریج
تعریف	تعاریف
تعقیب	تعقیبات
تعلیقه	تعالیق
تعلیم	تعالیم
تعلیم	تعلیمات
تعویذ	تعاویذ
تعیین	تعیینات
تغییر	تغاییر
تفرع	تفرعات
تفریح	تفریحات
تفریق	تفاریق
تفسیر	تفاسیر
تفصیل	تفاصیل
تفصیل	تفصیلات
تفکر	تفکرات
تقدیر	تقادیر
تقریر	تقاریر
تقسیم	تقاسیم
تقسیم	تقسیمات
تقصیر	تقاصیر
تقلیب	تقالیب
تقلید	تقالید
تقویم	تقاویم
تل	اتلال
تل	تلال
تلف	تلفات
تلمیذ	تلامذه
تلمیذ	تلامیذ
تمثال	تماثیل
تمساح	تماسیح
تنوفه	تنائف
تنوفه	تنایف
تهمت	تهم
تهنیت	تهانی
تو	توست
تواب	توابین
توجه	توجهات
تولید	تولیدات
توهم	توهمات
تَنوفَة	تنائف
تٲمین	تٲمینات
تٲمین	تامینات
تکلیف	تکالیف
تکمیل	تکمیلات
تکیه	تکایا
تیس	تیوس
ثابته	ثوابت
ثانیه	ثوانی
ثعبان	ثعابین
ثعلب	ثعالب
ثغر	ثغور
ثقبه	ثقب
ثقل	اثقال
ثقه	ثقات
ثمر	اثمار
ثمر	ثمار
ثمر	ثمرات
ثمرات	ثمره
ثمره	ثمرات
ثمن	اثمان
ثنا	اثنیه
ثنا	ثنایا
ثنیه	ثنایا
ثوب	اثواب
ثوب	ثیاب
جاذبه	جواذب
جار	جیران
جارحه	جوارح
جاریه	جواری
جاسوس	جواسیس
جامع	جوامع
جامعه	جوامع
جانب	جوانب
جانی	جنات
جاهل	جهال
جاهل	جهلا
جاهل	جهلاء
جایزه	جوائز
جایزه	جوایز
جبری	جبریون
جبل	جبال
جبهه	جبهات
جبیره	جبایر
جد	اجداد
جد	جدود
جدار	جدر
جدث	اجداث
جدول	جداول
جذر	جذور
جراحت	جراحات
جرثوم	جراثیم
جرس	اجراس
جرش	اجراس
جرم	اجرام
جرم	جرائم
جرم	جرایم
جرم	جروم
جریان	جریانات
جریحه	جرایح
جریده	جراید
جریمه	جرایم
جز	اجزا
جز	جزئیات
جز	جزییات
جزء	اجزا
جزء	اجزاء
جزء	جزئیات
جزء	جزییات
جزو	اجزا
جزو	اجزاء
جزوه	جزوات
جزیره	جزایر
جسد	اجساد
جسر	جسور
جسم	اجسام
جفن	اجفان
جلد	اجلاد
جلسه	اجلاس
جلف	اجلاف
جلیس	جلسا
جلیس	جلساء
جلیل	اجله
جمال	جماله
جمجمه	جماجم
جمره	جمرات
جمل	جمال
جمله	جمل
جمله	جملات
جمهور	جماهیر
جمهوری	جماهیر
جن	اجنه
جن	جان
جناح	اجنحه
جنازه	جنایز
جنازه	جنائز
جنایت	جنایات
جنت	جنان
جند	اجناد
جند	جنود
جنس	اجناس
جهاز	اجهزه
جهت	جهات
جواب	اجوبه
جواد	اجواد
جوان	جوانان
جوز	اجواز
جوف	اجواف
جوهر	جواهر
جوهر	جواهرات
جیب	جیوب
جید	اجیاد
جید	جیود
جیش	جیوش
جیل	اجیال
حوائل	حوائل
حوایل	حوایل
حاج	حجاج
حاج	حجیج
حاجب	حجاب
حاجب	حواجب
حاجت	حاجات
حاجت	حوائج
حاجت	حوایج
حاجز	حواجز
حاجه	حواج
حاجی	حجاج
حادثه	حادثات
حادثه	حوادث
حارث	حراث
حارس	حراس
حارس	حرسه
حاسد	حساد
حاشیه	حواشی
حاصل	حواصل
حاضر	حاضرین
حافظ	حفاظ
حال	احوال
حال	احوالات
حالت	حالات
حاکم	حکام
حب	حبوب
حباله	حبا
حباله	حبائل
حبر	احبار
حبس	حبست
حبس	حبوس
حبسیه	حبسیات
حبل	احبال
حبل	حبال
حبه	حبات
حبیب	احبا
حبیب	احباء
حبیب	احباب
حبیب	احبه
حتم	حتوم
حجة	حجج‌
حجةالاسلام	حجج
حجت	حجج
حجر	احجار
حجر	حجار
حجره	حجرات
حجم	احجام
حجه	حجج‌
حجهالاسلام	حجج
حد	حدود
حدث	احداث
حدقه	احداق
حدیث	احادیث
حدیقه	حدائق
حدیقه	حدایق
حر	احرار
حرف	احرف
حرف	حروف
حرفه	حرف
حرم	احرام
حروف	حروفات
حرکت	حرکات
حریف	حرفا
حریف	حرفاء
حزب	احزاب
حزن	احزان
حس	حواس
حسب	احساب
حسن	محاسن
حسنه	حسنات
حشره	حشرات
حشم	احشام
حصن	حصون
حصه	حصص
حضرت	حضرات
حظ	حظوظ
حفر	حفریات
حفره	حفر
حق	حقوق
حقب	احقاب
حقد	احقاد
حقنه	حقن
حقوق	حقوقات
حقیقت	حقایق
حل	احوالات
حلقه	حلقات
حلم	احلام
حله	حلل
حلیف	حلفا
حلیف	حلفاء
حمل	احمال
حمله	حملات
حنیف	حنفا
حنیف	حنفاء
حواری	حواریون
حواله	حوالات
حواله	حوالجات
حورا	حور
حوراء	حور
حول	حوالی
حکایت	حکایات
حکم	احکام
حکمت	حکم
حکیم	حکما
حیثیت	حیثیات
حیله	حیل
حین	احیان
حیه	حیات
خاتم	خواتم
خاتمه	خواتم
خاتمه	خواتیم
خاتون	خواتین
خادم	خدام
خادم	خدم
خادم	خدمه
خارجی	خوارج
خازن	خزان
خاصه	خواص
خاصگی	خاصگیان
خاصیت	خاصیات
خاصیت	خصایص
خاصیت	خصائص
خاطب	خطاب
خاطر	خواطر
خاطره	خاطرات
خاقان	خواقین
خال	اخوال
خالصه	خالصجات
خان	خوانین
خانقاه	خوانق
خانقه	خوانق
خبر	اخبار
خبره	خبرگان
خبی	خبایا
خبیثه	خبایث
خد	خدود
خدر	خدور
خدمات	خدمت
خدمت	خدمات
خدمت	خدمت‌کاران
خدن	اخدان
خدیعت	خدایع
خرج	اخراج
خرج	اخراجات
خرج	مخارج
خریده	خراید
خزانه	خزا
خزانه	خزائن
خزعبل	خزعبلات
خزینه	خزا
خزینه	خزاین
خسارت	خسارات
خشب	اخشاب
خشکبار	خشکبارات
خصلت	خصال
خصلت	خصایل
خصم	خصام
خصم	خصوم
خصوصیت	خصوصیات
خصیصه	خصائص
خصیصه	خصایص
خصیلت	خصایل
خصیلت	خصائل
خصیم	خصما
خصیم	خصماء
خط	خطوط
خطا	خطایا
خطابه	خطابات
خطبه	خطب
خطر	اخطار
خطه	خطط
خطوه	خطوات
خطی	خطایا
خطیئه	خطایا
خطیب	خطبا
خطیب	خطباء
خف	اخفاف
خفیه	خفایا
خلط	اخلاط
خلعت	خلع
خلف	اخلاف
خلق	اخلاق
خلق	خلایق
خلل	خلال
خلیفه	خلایف
خلیفه	خلائف
خلیفه	خلفا
خلیفه	خلفاء
خلیقه	خلایق
خلیقه	خلائق
خلیل	اخلا
خلیل	اخلاء
خمس	اخماس
خندق	خنادق
خنزیر	خنازیر
خوانده	خواندگان
خَریدة	خراید
خیر	اخیار
خیط	خیوط
خیل	خیول
خیمه	خیام
دایره	دوایر
دائره	دوائر
دابه	دواب
دار	دیار
داعی	دعات
داعی	دواعی
داعیه	دواعی
دانشگاهیان	دانشگاهی
داهیه	دواهی
دایره	دوایر
دخل	مداخل
در	درر
درایت	درایات
درج	ادراج
درجه	درجات
درجه	مدارج
درس	دروس
درقه	درق
درهم	دراهم
درویش	دراویش
درک	ادراک
دزد	دزدان
دسته	دستجات
دستور	دساتیر
دسکره	دساکر
دسیسه	دسایس
دسیسه	دسائس
دعا	ادعیه
دعاء	ادعیه
دعاوا	دعاوی
دعوا	دعاوی
دعوت	دعوات
دعوی	دعاوی
دفتر	دفاتر
دفعه	دفعات
دفینه	دفا
دقیقه	دقایق
دقیقه	دقائق
دلالت	دلالات
دلیل	ادله
دلیل	دلائل
دلیل	دلایل
دم	دما
دم	دماء
دنس	ادناس
دهر	ادهار
دهر	دهور
دهری	دهریون
دهقان	دهاقین
دهلیز	دهالیز
دهن	ادهان
دهنیت	دهنیات
دهه	دهگان
دوا	ادویه
دوا	دواجات
دور	ادوار
دوره	ادوار
دوشیزه	دوشیزگان
دولت	دول
دونده	دوندگان
دکان	دکاکین
دیانت	دیانات
دیده	دیدگان
دیر	ادیار
دیر	دیور
دین	ادیان
دین	دیون
دیوان	دواوین
ذئب	ذئاب
ذات	ذوات
ذباب	اذبه
ذخیره	ذخائر
ذخیره	ذخایر
ذراح	ذراریح
ذراع	آذرع
ذراع	اذرع
ذرع	ذراع
ذره	ذرات
ذریعه	ذرایع
ذریه	ذراری
ذریه	ذریات
ذم	ذموم
ذمه	ذمم
ذمیمه	ذما
ذمیمه	ذمائم
ذنب	اذناب
ذنب	ذنوب
ذهن	اذهان
ذوذنب	ذوات
ذوذنب	ذوات‌الاذناب
ذوق	اذواق
ذکر	اذکار
ذکر	ذکور
ذیل	اذیال
ذیل	ذیول
رئیس	رؤسا
رئیس	رؤساء
رأس	رؤوس
رأس	رئوس
رأی	آرا
رأی	آراء
رئیس	روسا
رابطه	روابط
راتب	رواتب
راتبه	رواتب
راحل	رحال
راحله	رواحل
راس	ریوس
راعی	رعات
رافضی	روافض
راهب	رهبان
راوی	روات
راویه	روایا
راکب	راکبین
رایت	رایات
رائحه	روائح
رایحه	روایح
رب	ارباب
رب	ربوب
رباط	اربطه
ربح	ارباح
ربض	ارباض
ربع	ارباع
ربع	ربوع
ربیبه	ربایب
رتبه	رتب
رجا	ارجا
رجس	ارجاس
رجل	ارجل
رجل	رجال
رحل	رحال
رحم	ارحام
رخت	ارخته
رخت	رخوت
ردف	ارداف
رذل	ارذال
رذل	رذول
رذیلت	رذایل
رذیله	رذایل
رزق	ارزاق
رسال	رسایل
رساله	رسا
رساله	رسائل
رسم	رسوم
رسم	رسومات
رسول	رسل
رسول	رسوله
رشحه	رشحات
رعیت	رعایا
رغیبه	رغا
رغیبه	رغائب
رغیف	ارغفه
رف	رفاف
رف	رفوف
رفیق	رفقا
رقبه	رقاب
رقعه	رقاع
رقم	ارقام
رقم	رقوم
رقیب	رقبا
رقیب	رقباء
رقیق	ارقا
رمح	رماح
رمز	رموز
رمل	رمال
رند	رنود
رهم	ارحام
رهن	رهان
رهن	رهون
رواقی	رواقیون
روایت	روایات
روث	ارواث
روح	ارواح
روحانی	روحانیون
روحیه	روحیات
روزنامه	روزنامجات
روشن	روشان
روضه	روضات
روضه	ریاض
رکعت	رکعات
رکن	ارکان
ریح	اریاح
ریح	ریاح
ریحان	ریاحین
ریزمکالمه	ریزمکالمات
زائر	زوار
زارع	زارعین
زاهد	زهاد
زاویه	زوایا
زایده	زواید
زایده	زوائد
زایر	زایرین
زائر	زائرین
زایر	زوار
زحمت	زحمات
زخرف	زخارف
زعیم	زعما
زعیم	زعماء
زل	زلات
زلزله	زلازل
زمام	ازمه
زمان	ازما‌ن
زمان	ازمنه
زمره	زمر
زنده	زندگان
زندیق	زنادقه
زندیق	زنادیق
زهر	ازهار
زهر	زهور
زوج	ازواج
زوجه	زوجات
زکات	زکوات
زیارت	زیارات
زیج	زیجات
سؤال	اسئله
سؤال	اسوله
سؤال	سائل
سوال	اسوله
سوال	سایل
سوال	اسئله
سائمه	سوائم
سابقه	سوابق
ساتر	سواتر
ساتِر	سواتر
ساحر	سحره
ساحل	سواحل
سادن	سدنه
سادِن	سدنه
ساعت	ساعات
ساعی	سعات
سافر	سفره
ساقی	سقات
ساقی	سقاط
ساقیه	سواقی
ساقیّة	سواقی
سالبه	سوالب
سالف	سوالف
سال	سالیان
سامع	سامعین
سامه	سوام
سامَّة	سوام
سانحه	سوانح
سانِحَة	سوانح
ساکن	سکنه
سایمه	سوایم
سبب	اسباب
سبحه	سبحات
سبزی	سبزیجات
سبط	اسباط
سبع	سباع
سبق	اسباق
سبلت	سبال
سبی	سبایا
سبیل	سبل
سبیکه	سبائک
سبیکه	سبایک
ستر	استار
ستر	ستور
ستم	ستم‌دیدگان
ستم‌دیده	ستم
سجده	سجدات
سجع	اسجاع
سجف	سجوف
سجل	سجلات
سجن	اسجان
سجیه	سجایا
سحابه	سحایب
سحابه	سحائب
سحر	اسحار
سخی	اسخیا
سد	سدود
سر	اسرار
سر	سران
سرحد	سرحدات
سرقت	سرقات
سروال	سراویل
سرّیّة	سراری
سرّیَّة	سریات
سریر	سرر
سریره	سرا
سریره	سرایر
سریه	سراری
سریه	سرایا
سریه	سریات
سطح	سطوح
سطر	اسطار
سطر	سطور
سطوت	سطوات
سعد	سعود
سعی	مساعی
سعید	سعدا
سـجال	سجال
سـَجال	سجال
سفته	سفته‌جات
سفر	اسفار
سفله	سفلگان
سفلیه	سفلیات
سفلیَّة	سفلیات
سفیر	سفرا
سفیر	سفراء
سفیل	سفلا
سفیل	سفلاء
سفینه	سفائن
سفینه	سفاین
سفینه	سفن
سفیه	سفها
سفیه	سفهاء
سقت	اسقاط
سقط	اسقاط
سقف	سقوف
سقلابی	سقالبه
سقلابی	سقلابه
سقم	اسقام
سقیم	سقام
سلجوق	سلاجقه
سلسله	سلاسل
سلطان	سلاطین
سلف	اسلاف
سلک	اسلاک
سلیقه	سلائق
سلیقه	سلایق
سلیقه	سلق
سم	سموم
سما	سماوات
سما	سموات
سماء	سموات
سمت	سموت
سمر	اسمار
سمع	اسماع
سمه	سمات
سموم	سما
سموم	سمائم
سموم	سمایم
سموم	سمومات
سمک	اسماک
سمک	سماک
سن	اسنان
سن	سنین
سنان	اسنه
سنبل	سنابل
سنبله	سنابل
سنبک	سنابک
سنت	سنن
سنجق	سناجق
سند	اسناد
سنه	سنوات
سنه	سنون
سنه	سنین
سنوات	سنه
سهب	سهوب
سهل	سهل
سهل	سهول
سهم	اسهام
سهم	سهام
سهو	سهویات
سوار	اساور
سوار	اسواره
سوال	اسیله
سور	اسوار
سوره	سور
سوره	سورات
سوط	سیاط
سوق	اسواق
سَبیّ	سبایا
سَحابَة	سحایب
سَحابَة	سحائب
سَریَّة	سرایا
سَفینة	سفن
سَمت	سموت
سَموم	سمومات
سَنجَق	سناجق
سَنَة	سنون
سَوط	سیاط
سُرّیَّة	سراری
سُنبُک	سنابک
سُهب	سهوب
سِجَف	سجوف
سِمَة	سمات
سکون	سکنات
سگ	سگان
سی	سیئات
سیئه	سيئات
سیئه	سی
سیئه	سیئات
سیادت	سیادات
سیاره	سیارات
سید	سادات
سیده	سیدات
سیرت	سیر
سیره	سیر
سیرَة	سیر
سیف	سیوف
شأن	شؤون
شأن	شئون
شأن	شئونات
شائبه	شوایب
شایبه	شوایب
شاب	شباب
شارب	شوارب
شارع	شوارع
شارع	شواره
شاعر	شعرا
شاعر	شعراء
شامه	شامات
شان	شوون
شاهد	شهود
شاهد	شواهد
شاکی	شکات
شایبه	شوائب
شایعه	شایعات
شبح	اشباح
شبر	اشبار
شبل	اشبال
شبه	اشباه
شبهه	شبهات
شت	اشتات
شجر	اشجار
شجره	اشجار
شجن	اشجان
شخص	اشخاص
شخصیت	شخصیات
شدیده	شدا
شر	اشرار
شراب	اشرابه
شراب	اشربه
شراره	شرار
شراره	شرر
شرط	شرایط
شرط	شرائط
شرط	شروط
شرفه	شرف
شریان	شرایین
شریر	اشرار
شریعت	شرایع
شریف	اشراف
شریف	شرفا
شریف	شرفاء
شریک	شرکا
شریک	شرکاء
شعار	اشعه
شعاع	اشعه
شعب	شعوب
شعبه	شعب
شعبه	شعبات
شعر	اشعار
شغل	اشغال
شغل	مشاغل
شفه	شفاه
شق	شقوق
شقی	اشقیا
شقی	اشقیاء
شقیقه	شقایق
شمس	شموس
شموم	شمومات
شمیمه	شمائم
شناگر	شناگران
شنیعه	شنایع
شهاب	شهب
شهر	اشهر
شهر	شهور
شهوت	شهوات
شهید	شهدا
شهید	شهداء
شوق	اشواق
شوک	اشواک
شک	شکوک
شکاکی	شکاکیون
شکایت	شکایات
شکل	اشکال
شی	اشیا
شی	اشیاء
شیء	اشیا
شیخ	شیوخ
شیخ	مشایخ
شیرینی	شیرینیجات
شیطان	شیاطین
شیعه	اشیاع
شیعَة	اشیاع
شیمه	شیم
صاحب	اصحاب
صاحب	صحابه
صاعقه	صواعق
صالح	اصلح
صالح	صلحا
صالح	صلحاء
صانع	صناع
صبح	اصباح
صبی	صبیان
صبیه	صبایا
صحرا	صحاری
صحراء	صحاری
صحیح	اصحا
صحیفه	صحایف
صحیفه	صحف
صدر	صدور
صدغ	اصداغ
صدف	اصداف
صدقه	صدقات
صدمه	صدمات
صدیق	اصدقا
صرصر	صراصر
صرفی	صرفیون
صره	صرر
صعوبت	صعوبات
صغیر	صغار
صغیره	صغایر
صف	صفوف
صفاد	اصفاد
صفت	صفات
صفحه	صفحات
صفر	اصفار
صفی	اصفیا
صقالبه	سقالبه
صقع	اصقاع
صلات	صلوات
صلب	اصلاب
صله	صلات
صلیبی	صلیبیون
صم	اصم
صناعت	صناعات
صندوق	صنادیق
صندید	صنادید
صنعت	صنایع
صنف	اصناف
صنف	صنوف
صنم	اصنام
صنیعه	صنایع
صوت	اصوات
صورت	صور
صومعه	صوامع
صُقع	اصقاع
صیغه	صیغ
ضابط	ضباط
ضابط	ضوابط
ضابطه	ضوابط
ضایعه	ضایعات
ضحیه	ضحایا
ضحیه	ضحایاء
ضد	اضداد
ضرب	اضراب
ضرب	ضروب
ضربت	ضربات
ضربه	ضربات
ضرر	اضرار
ضرر	مضار
ضرس	اضراس
ضرس	ضروس
ضریب	ضرایب
ضریح	ضرایح
ضعف	اضعاف
ضعیف	ضعفا
ضعیف	ضعفاء
ضغث	اضغاث
ضفدع	ضفادع
ضلع	اضلاع
ضلی	اضلاع
ضمیر	ضمایر
ضمیمه	ضمایم
ضو	اضوا
ضوء	اضوا
ضیعه	ضیاع
ضیف	اضیاف
ضیف	ضیوف
طائفه	طوا
طائل	طوا
طاحنه	طواحن
طاحون	طواحین
طاحونه	طواحین
طاعت	طاعات
طاغوت	طواغی
طاغوت	طواغیت
طاغی	طغات
طاقه	طاقات
طامه	طالمات
طامه	طامات
طاهر	اطهار
طایر	طیور
طایفه	طوائر
طایفه	طوایر
طایفه	طوایف
طایل	طوائل
طایل	طوایل
طبع	اطباع
طبع	طباع
طبع	طبایع
طبق	اطباق
طبقه	طبقات
طبیب	اطبا
طبیعت	طبایع
طرفه	طرف
طره	طرر
طریفه	طرائف
طریفه	طرایف
طریق	طرف
طریق	طرق
طریقت	طرائق
طریقت	طرایق
طعام	اطعمه
طعمه	طعم
طفل	اطفال
طل	طلال
طل	طلل
طلب	اطلاب
طلبه	طلاب
طلسم	طلاسم
طلل	طلول
طلیعه	طلایع
طلیعه	طلایی
طمع	مطامع
طنب	اطناب
طور	اطوار
طوق	اطواق
طومار	طوامیر
طومار	طولمیر
طیاره	طیارات
طیب	اطیاب
طیبه	طیبات
طیر	اطیار
طیر	طیور
ظالم	ظلام
ظالم	ظلمه
ظاهر	اظهر
ظاهر	ظواهر
ظرف	ظروف
ظریف	ظرفا
ظریف	ظرفاء
ظریفه	ظرایف
ظفر	اظفار
ظل	اظلال
ظل	ظلال
ظلامت	ظلامات
ظلامه	ظلامات
ظلمت	ظلامات
ظلمت	ظلمات
ظن	ظنون
ظهر	ظهور
ظهیر	ظهرا
ظهیر	ظهراء
عائده	عوائد
عابد	عبده
عابر	عابرین
عاجز	عجزه
عادت	عادات
عارضه	عوارض
عارف	عرفا
عارف	عرفاء
عاشق	عاشق
عاشق	عشاق
عاصی	عاصات
عاصی	عصاة
عاصی	عصات
عاصی	عصاه
عاطفه	عاطفات
عاطفه	عواطف
عاقب	عواقب
عاقبت	عواقب
عاقل	عقلا
عاقل	عقلاء
عالم	علما
عالم	علماء
عالم	عوالم
عالم	عوالمات
عالمی	عالمیان
عام	عوام
عامل	عمال
عامل	عمله
عامل	عوامل
عایده	عایدات
عایده	عوائد
عایده	عواید
عایقه	عوائق
عایقه	عوایق
عباد	عباد
عبادت	عبادات
عبارت	عبارات
عبد	عباد
عبد	عبید
عبرت	عبر
عتبه	اعتاب
عتبه	عتبات
عجز	اعجاز
عجم	اعجام
عجیب	عجایب
عجیبه	عجائب
عجیبه	عجایب
عداوت	عدوات
عدد	اعداد
عدد	عداد
عدم	اعدام
عدو	اعادی
عدو	اعدا
عدو	اعداء
عذر	اعذار
عذر	معاذیر
عرب	اعراب
عرصه	اعراص
عرصه	عرصات
عرض	اعراض
عرق	اعراق
عرق	عروق
عروض	اعاریض
عریضه	عرائض
عریضه	عرایض
عریضه	عریضجات
عریکه	عرائک
عریکه	عرایک
عزب	عزاب
عزیز	اعزا
عزیمت	عزایم
عسکر	عساکر
عشر	اعشار
عشره	عشرات
عشقیه	عشقیات
عشیره	عشائر
عشیره	عشایر
عصب	اعصاب
عصر	اعصار
عصر	عصور
عصفور	عصافیر
عضله	عضلات
عضو	اعضا
عضو	اعضاء
عطر	عطور
عطف	اعطاف
عطیت	عطایا
عطیت	عطایاء
عظم	عظام
عظیم	عظما
عفریت	عفاریت
عفونت	عفونات
عفیف	اعفا
عقبه	اعقاب
عقبه	عقبات
عقد	عقود
عقده	عقد
عقرب	عقارب
عقل	عقلا
عقل	عقول
عقوبه	عقوبات
عقود	عقودات
عقیده	عقائد
عقیده	عقاید
علاقه	علائق
علاقه	علاقات
علاقه	علایق
علامت	علائم
علامت	علامات
علامت	علایم
علت	علل
علف	علوفه
علق	اعلاق
علم	اعلام
علم	اعلوم
علم	علوم
علوفه	علوفات
عم	اعمام
عمارت	عمارات
عمامه	عمائم
عمامه	عمایم
عمر	اعمار
عمق	اعماق
عمل	اعمال
عمله	عمال
عمله	عملجات
عنایت	عنایات
عنب	اعناب
عنصر	عناصر
عنق	اعناق
عنوان	عناوین
عنکبوت	عناکب
عهد	عهود
عود	اعواد
عون	اعوان
عیب	عیوب
عیب	عیوبات
عیب	معایب
عید	اعیاد
عین	اعیان
عین	اعین
عین	عیون
غائب	غایبین
غائله	غوائل
غایله	غوایل‌‌
غابه	غاب
غار	اغوار
غارت	غارات
غازی	غزات
غاشیه	غواشی
غامضه	غوامض
غایب	غائبین
غایب	غایبین
غایت	غایات
غایله	غوائل
غایله	غوایل
غبی	اغبیا
غده	غدد
غذا	اغذیه
غرامت	غرامات
غربا	غریب
غرباء	غریب
غربی	غربیون
غرس	اغراس
غرض	اغراض
غرفه	غرف
غرفه	غرفات
غره	غرر
غریب	غربا
غریبه	غرائب
غریبه	غرایب
غریزه	غرائز
غریزه	غرایز
غریم	غرما
غریم	غرماء
غزا	غزوات
غزاء	غزوات
غزل	غزلیات
غشا	اغشیه
غشاء	اغشیه
غصن	اغصان
غصن	غصون
غضروف	غضاریف
غطا	اغطیه
غل	اغلال
غل	غلال
غلام	اغلمه
غلام	غلمان
غلط	اغلاط
غله	غلات
غم	غموم
غمر	اغمار
غنی	اغنیا
غنیمت	غنایم
غواشیه	غواشی
غول	اغوال
غول	غلان
غول	غیلان
غوک	غوکان
غَبیّ	اغبیا
غیب	غیوب
غیر	اغیار
غیم	غیوم
فاجعه	فواجع
فاحشه	فواحش
فارس	فوارس
فارسی	فارسیان
فارقت	فارقات
فاسق	فاساق
فاسق	فساق
فاصله	فواصل
فاضل	فضلا
فاضل	فضلاء
فاکهه	فواکه
فایده	فواید
فتح	فتوح
فتح	فتوحات
فتنه	فتن
فتوا	فتاوا
فتوی	فتاوی
فتی	فتیان
فجیعه	فجایع
فحل	فحول
فرج	فروج
فرجه	فرج
فرد	افراد
فرزانه	فرزانگان
فرستاده	فرستادگان
فرض	فروض
فرضیه	فرضیات
فرع	فروع
فرع	فروعات
فرعون	فراعنه
فرقه	فرق
فرمان	فرامین
فروشنده	فروشندگان
فریده	فراید
فریده	فرائد
فریضه	فرائض
فریضه	فرایض
فریضه	فرائض
فصل	فصول
فصیح	فصحا
فصیح	فصحاء
فضله	فضلات
فضیحت	فضایح
فضیحت	فضائح
فضیلت	فضائل
فضیلت	فضایل
فضیلت	فضائل
فعل	افاعیل
فعل	افعال
فقر	فقرا
فقره	فقرات
فقیر	فقرا
فقیر	فقراء
فقیه	فقها
فقیه	فقهاء
فلز	فلزات
فلس	فلوس
فلک	افلاک
فلکی	فلکیون
فم	افواه
فن	فنون
فنن	افانین
فنن	افنان
فهرس	فهارس
فهلویه	فهلویات
فوج	افواج
فوه	افواه
فکر	افکار
فیض	فیوض
فیض	فیوضات
فیل	افیال
فیلسوف	فلاسفه
قائده	قوائد
قابض	قابضات
قاتل	قتال
قاری	قار
قاری	قرا
قاری	قراء
قاضی	قضات
قاطع	قطاع‌الطریق
قاطع‌الطریق	قطاع
قاعده	قواعد
قافله	قوافل
قافیه	قوافی
قانون	قوانین
قباله	قبالات
قباله	قبالجات
قبر	قبور
قبض	قبوض
قبیحه	قبایح
قبیله	قبائل
قبیله	قبایل
قحف	اقحاف
قدح	اقداح
قدر	اقدار
قدسی	قدسیان
قدم	اقدام
قدم	قدوم
قرائت	قرائات
قرابت	قرابات
قرحه	قروح
قرد	قرود
قرص	اقراص
قرض	قروض
قرطاس	قراطیس
قرمطی	قرامطه
قرن	اقران
قرن	قرون
قریب	اقربا
قریب	اقرباء
قریحه	قرایح
قرین	اقران
قرینه	قرائن
قرینه	قراین
قریه	قرا
قریه	قری
قس	قسوس
قسط	اقساط
قسم	اقسام
قشر	اقشار
قشر	قشور
قصبه	قصبات
قصر	قصور
قصه	اقاصیص
قصه	قصص
قصیده	قصائد
قصیده	قصاید
قصیده	قصائد
قضیه	قضایا
قضیه	قضایاء
قطب	اقطاب
قطر	اقطار
قطره	قطرات
قطعه	قطع
قطعه	قطعات
قفل	اقفال
قلاده	قلاید
قلب	قلوب
قلعه	قلاع
قلم	اقلام
قله	قلل
قماش	اقمشه
قمر	اقمار
قنات	قنوات
قندیل	قنادیل
قنطار	قناطیر
قنطره	قناطر
قوت	اقوات
قوس	اقواس
قول	اقوال
قوم	اقوام
قوه	قوا
قوی	اقویا
قید	قیود
قیصر	قیاصره
قیل	اقیال
قیمت	قیم
ل	لئام
لؤلؤ	لآلی
لئیم	ل
لاادری	لاادرییون
لاحقه	لواحق
لازمه	اوازم
لازمه	لوازم
لایحه	لوایح
لایحه	لوائح
لب	الباب
لباس	البسه
لبان	البان
لبیب	البا
لثه	لثات
لحظ	الحاظ
لحم	الحام
لحم	لحوم
لحن	الحان
لذت	لذات
لذت	لذایذ
لذیذ	لذائذ
لذیذ	لذایذ
لر	الوار
لزوجت	لزوجات
لسان	السن
لسان	السنه
لشکری	لشکریان
لطف	الطاف
لطمه	لطمات
لطیفه	لطا
لطیفه	لطائف
لطیفه	لطایف
لعبت	لعب
لغت	لغات
لغز	الغاز
لغوی	لغویون
لفافه	لفا
لفافه	لفائف
لفظ	الفاظ
لقب	القاب
لمعه	لمعات
لوا	الویه
لواء	الویه
لوث	الواث
لوح	الواح
لوطی	الواط
لون	الوان
لیف	الیاف
لیل	لیالی
مأخذ	مآخذ
مأربه	مآرب
مؤخره	مؤخرات
مؤسسه	مؤسسات
مئه	مآت
ما	امواه
ما	مئات
ما	مياه
ما	میاه
ماء	مياه
ماده	مواد
مادی	ماديان
مادی	ماديون
مادی	مادیات
مادی	مادیون
مال	اموال
مانع	موانع
مانوی	مانویون
مایع	مایعات
مباحثه	مباحثات
مبادله	مبادلات
مبارزه	مبارزات
مباینت	مباینات
مبحث	مباحث
مبدأ	مبادی
مبلع	مبالغ
مبلغ	مبالغ
مبلغ	مبلغین
مبنا	مبانی
مبنی	مبانی
مبهمه	مبهمات
متاع	امتعه
متشابه	متشابات
متشابه	متشابهات
متعلقه	متعلقات
متفق	متفقین
متن	متون
متهم	متهمان
متوفی	متوفیات
مثال	امثله
مثل	امثال
مثل	امثالهم
مجادله	مجادلات
مجاز	مجازات
مجاهدت	مجاهدات
مجرا	مجاری
مجسمات	مجسمه
مجسمه	مجسمات
مجلس	مجالس
مجلسی	مجلسیان
مجله	مجلات
مجمر	مجامر
مجمره	مجامر
مجمع	مجامع
مجنون	مجانین
محاربه	محاربات
محاسبه	محاسبات
محاوره	محاورات
محاکمه	محاکمات
محتوی	محتویات
محرم	محارم
محصول	محاصیل
محصول	محصولات
محضر	محاضر
محفل	محافل
محل	محال
محلله	محللات
محله	محلات
محمده	محامد
محمل	محامل
محموله	محمولات
محنت	محن
محکمه	محاکم
مخابره	مخابرات
مخازن	مخزن
مخاطره	مخاطرات
مخالف	مخالفین
مخترعه	مخترعات
مخدره	مخدرات
مخدوم	مخادیم
مخرج	مخارج
مخزن	مخازن
مخلوق	مخلوقات
مخیله	مخیلات
مداخله	مداخلات
مدخل	مداخل
مدد	امداد
مدرسه	مدارس
مدرک	مدارک
مدعو	مدعوین
مدیحه	مدایح
مدینه	مدائن
مدینه	مداین
مدینه	مدن
مذاکره	مذاکرات
مذبح	مذابح
مذهب	مذاهب
مرآت	مرایا
مرابطه	مرابطات
مراجعه	مراجعات
مراحم	مرحمت
مراسله	مراسلات
مرافقت	مرافقات
مراقبت	مراقبات
مراقبه	مراقبات
مراوده	مراودات
مرتبه	مراتب
مرتع	مراتع
مرتفع	مرتفعات
مرثیه	مراثی
مرج	مروج
مرجع	مراجع
مرحله	مراحل
مرحمت	مراحم
مرده	مردگان
مرسوله	مرسولات
مرصد	مراصد
مرض	امراض
مرقد	مراقد
مرقومه	مرقومات
مرمی	مرمیات
مره	مرات
مرهم	مراهم
مرکب	مراکب
مرکز	مراکز
مریض	مرضا
مریض	مرضی
مزاج	امزجه
مزایده	مزایدات
مزرعه	مزارع
مزمار	مزامیر
مزمور	مزامیر
مزیت	مزایا
مس	مسئولین
مس	مسائل
مسئله	مسا
مسئله	مسائل
مسئله	مسایل
مسافت	مسافات
مسافحه	مسافحات
مسامره	مسامرات
مستحاثه	مستحاثات
مستدعا	مستدعیات
مستدعی	مستدعیات
مستضعف	مستضعفین
مستعمره	مستعمرات
مستلذ	مستلذات
مستملکه	مستملکات
مستکبر	مستکبرین
مسجد	مساجد
مسرت	مسرات
مسطحه	مسطحات
مسطوره	مسطورجات
مسلک	مسالک
مسمار	مسامیر
مسمع	مسامع
مسند	مساند
مسند	مسانید
مسوده	مسودات
مسکن	مساکن
مسکین	مساکین
مسیحی	مسیحیون
مسیحیون	مسیحی
مشاعر	مشعر
مشافهه	مشافهات
مشاهدات	مشاهده
مشاهده	مشاهدات
مشاهره	مشاهرات
مشاوره	مشاورات
مشایخ	شیخ
مشایع	مشایعین
مشترک	مشترکات
مشتق	مشتقات
مشج	امشاج
مشعر	مشاعر
مشعل	مشاعل
مشغله	مشاغل
مشغولیت	مشغولیات
مشقت	مشاق
مشقت	مشقات
مشهد	مشاهد
مصاحف	مصحف
مصادره	مصادرات
مصباح	مصابیح
مصحف	مصاحف
مصداق	مصادق
مصداق	مصادیق
مصدر	مصادر
مصر	امصار
مصراع	مصاریع
مصرف	مصارف
مصعب	مصاعب
مصلحت	مصالح
مصنوع	مصنوعات
مصوبه	مصوبات
مصیبت	مصائب
مصیبت	مصایب
مضجع	مضاجع
مضرب	مضارب
مضرت	مضار
مضرت	مضرات
مضمون	مضامین
مضیق	مضائق
مضیق	مضایق
مضیقه	مضائق
مضیقه	مضایق
مطالبه	مطالبات
مطالعه	مطالعات
مطایبه	مطایبات
مطبخ	مطابخ
مطبعه	مطابع
مطر	امطار
مطرق	مطارق
مطلب	مطالب
مطلع	مطالع
مطلقه	مطلقات
مطمح	مطامح
مطمع	مطامع
مظان	مظنه
مظلمه	مظالم
مظهر	مظاهر
معا	امعا
معا	امعاء
معاء	امعا
معادله	معادلات
معارضه	معارضات
معالجه	معالجات
معامله	معاملات
معبد	معابد
معبر	معابر
معتمد	معتمدین
معجزه	معجزات
معجم	معاجم
معجون	معاجین
معدن	معادن
معذرت	معاذیر
معراج	معارج
معرفت	معارف
معروشه	معروشات
معروف	معاریف
معرکه	معارک
معصوم	معصومین
معصیت	معاصی
معضله	معضلات
معلقه	معلقات
معلم	معالم
معنی	معانی
معوقه	معوقات
معیار	معاییر
مغ	مغان
مغاره	مغارات
مغاره	مغاور
مغربی	مغاربه
مفتاح	مفاتیح
مفخرت	مفاخر
مفرش	مفارش
مفرق	مفارق
مفسده	مفاسد
مفصل	مفاصل
مفهوم	مفاهیم
مقابله	مقابلات
مقاربت	مقاربات
مقاله	مقالات
مقام	مقامات
مقاوله	مقاولات
مقاومت	مقاومات
مقایسه	مقایسات
مقبره	مقابر
مقتضا	مقتضیات
مقتضی	مقتضیات
مقتل	مقاتل
مقدار	مقادیر
مقدس	مقدسین
مقصد	مقاصد
مقطع	مقاطع
مقعد	مقاعد
مقنطره	مقنطرات
مقوله	مقولات
ملاحظه	ملاحظات
ملاحم	ملحمه
ملازم	ملازمین
ملازمت	ملازمات
ملازمه	ملازمات
ملبس	ملابس
ملت	ملل
ملتزم	ملتزمین
ملح	املاح
ملحد	ملاحده
ملحمه	ملاحم
ملعبه	ملاعب
ملعون	ملاعین
ملفوفه	ملفوفات
ملمع	ملمعات
ملک	املاک
ملک	ملائک
ملک	ملایک
ملک	ملوک
ملکه	ملکات
ملیک	ملکا
مملوک	ممامیک
مملکت	ممالک
منازعت	منازعات
منازعه	منازعات
مناسبت	مناسبات
مناظرات	مناظره
مناظره	مناظرات
مناقشه	مناقشات
منامندیل	منادیل
منبر	منابر
منبع	منابع
منجنیق	مناجیق
منجنیک	مناجیق
مندیل	منادیل
منزل	منازل
منسوج	منسوجات
منسک	مناسک
منصب	مناصب
منطقه	مناطق
منظر	مناظر
منظره	مناظر
منظومه	منظومات
منفذ	منافذ
منفعت	منافع
منقبت	مناقب
منهاج	مناهیج
منهج	مناهج
منهی	مناهی
منهی	منهیات
منویه	منویات
منیت	منایا
منیت	منی
منیرا	ارامنه
مهد	مهود
مهر	امهار
مهره	مهره‌داران
مهلکه	مهالک
مهم	مهمات
مواثیق	میثاق
مواجهه	مواجهات
مواصلت	مواصلات
مواصله	مواصلات
موج	امواج
موجب	موجبات
موجه	موجهات
موجود	موجودات
مورد	موارد
موسسه	موسسات
موسم	مواسم
موضع	مواضع
موضوع	مواضیع
موطن	مواطن
موعد	مواعد
موعظت	مواعظ
موعظه	مواعظ
موعظه	مواعظ
موفقیت	موفقیات
موقع	مواقع
موقف	مواقف
موقوفه	موقوفات
مولا	موالی
مولود	موالید
مولی	موالی
موهبت	مواهب
موهبه	مواهب
موکب	مواکب
مژه	مژگان
مکاتبه	مکاتبات
مکاشفت	مکاشفات
مکالمه	مکالمات
مکان	اماکن
مکان	امکنه
مکانت	مکانات
مکتب	مکاتب
مکتوب	مکاتیب
مکرمت	مکارم
مکرمه	مکارم
مکسب	مکاسب
مکمن	مکامن
مکنون	مکنونات
مکیال	مکا
مکیال	مکائل
مکیفه	مکیفات
میت	اموات
میت	موتا
میت	موتی
میثاق	مواثیق
میدان	میادین
میراث	مواریث
میزان	موازین
میل	امیال
میمنت	میامن
میمنت	میامین
میوه	میوجات
نا	نوائب
ناب	انابیب
ناب	انیاب
نابته	نوابت
نابغه	نوابغ
ناحیه	ناحیت
ناحیه	نواحی
نادره	نادرات
نادره	نوادر
نادم	ندام
نار	انوار
نار	نیران
ناسخ	نساخ
ناسور	نواسیر
ناسک	نساک
ناصبی	نواصب
ناصح	نصاح
ناصح	نصحا
ناصح	نصحاء
ناصر	انصار
ناصیه	نواصی
ناظر	نظار
نافذه	نوافذ
نافله	نوافل
ناقل	نقله
ناقوس	نواقیس
نامبرده	نامبردگان
ناملایمت	ناملايمات
ناموس	نوامیس
نامیه	نوامی
ناهیه	نواهی
نایب	نواب
نایبه	نایبات
نبأ	انبا
نبا	انبا
نبا	انباء
نبی	انبیا
نبی	انبیاء
نبیل	نبلا
نبیل	نبلاء
نبیه	نبها
نبیه	نبهاء
نتیجه	نتایج
نتیجه	نتائج
نجاست	نجاسات
نجد	انجاد
نجس	انجاس
نجل	انجال
نجم	انجم
نجم	نجوم
نجیبه	نجایب
نحر	نحور
نحس	نحوس
نحله	نحل
نحو	انحا
نحو	انحاء
نحوی	نحویون
نخروب	نخاریب
ند	انداد
ندیم	ندما
ندیم	ندماء
ندیٰ	اندیه
نذر	نذور
نذر	نذورات
نره	نرگان
نزل	انزال
نزله	نزلات
نزیل	نزلا
نزیل	نزلاء
نسا	نسوان
نسب	انساب
نسج	انساج
نسج	نسوج
نسخه	نسخ
نسر	نسور
نسطوری	نساطره
نسل	انسال
نسیج	نسایج
نشریه	نشریات
نص	نصوص
نصرانی	نصارا
نصرانی	نصاری
نصیب	انصبا
نصیحت	نصایح
نصیحت	نصائح
نصیر	انصار
نصیر	نصرا
نصیر	نصراء
نطاق	نطق
نطع	انطا
نطع	انطاء
نظر	انظار
نظریه	نظریات
نظیر	نظایر
نعل	نعال
نعم	انعام
نعمت	نعم
نعمت	نعمات
نغمه	نغمات
نفس	انفاس
نفس	انفس
نفس	نفوس
نفل	انفال
نفیسه	نفایس
نقد	نقود
نقره	نقرات
نقس	انقاس
نقش	نقوش
نقص	نقایص
نقص	نواقص
نقض	انقاض
نقطه	نقاط
نقطه	نقط
نقل	انکال
نقل	نقول
نقیب	نقبا
نقیب	نقباء
نقیصه	نقایص
نقیضه	نقایض
نمره	نمرات
نمس	نموس
نهر	انهار
نهضت	نهضات
نو	انوا
نواده	نوادگان
نوباوه	نوباوگان
نور	انوار
نوزاده	نوزادگان
نوشته	نوشتجات
نوع	انواع
نکبت	نکبات
نکته	نکات
نکته	نکت
نی	اغنیا
نیا	نیاکان
نیا	نیاگان
نیت	نیات
هاجس	هواجس
هاله	هوام
هامه	هوام
هتر	اهتار
هجو	هجویات
هدب	اهداب
هدف	اهداف
هدیه	هدایا
هرم	اهرام
هزهزه	هزاهز
هلال	اهله
هم	هموم
همت	همم
هندی	هنود
هودج	هوادج
هول	اهوال
هوی	اهوا
هیأت	هیئات
هیکل	هیاکل
وابسته	وابستگان
واحه	واحات
وادی	اودیه
وارث	وراث
وارث	ورثه
واسطه	وسا
واسطه	وسائط
واعظ	وعاظ
واقعه	واقعات
واقعه	وقایع
واقعیت	واقعیات
والی	ولاة
والی	ولات
والی	ولاه
وتد	اوتاد
وتر	اوتار
وثن	اوثان
وثیقه	وثا
وثیقه	وثائق
وثیقه	وثایق
وجع	اوجاع
وجل	اوجال
وجنه	وجنات
وجه	وجوه
وجه	وجوهات
وحش	وحوش
وحل	اوحال
وداج	اوداج
ودید	اودا
ودیعه	ودایع
ورد	اوراد
ورق	اوراق
ورم	اورام
ورید	اورده
وزر	اوزار
وزن	اوزان
وزیر	وزرا
وزیر	وزراء
وسخ	اوساخ
وسط	اواسط
وسط	اوساط
وسوسه	وساوس
وسیله	وسایل
وصب	اوصاب
وصف	اوصاف
وصل	اوصال
وصی	اوصیا
وصیت	وصایا
وصیت	وصایاء
وضح	اوضاح
وضع	اوضاع
وطر	اوطار
وطن	اوطان
وظیفه	وظائف
وظیفه	وظایف
وعا	اوعیه
وعد	وعود
وغد	اوغاد
وقت	اوقات
وقف	اوقاف
ولایت	ولایات
ولد	اولاد
ولی	اولیا
ولی	اولیاء
ولیمه	ولا
ولیمه	ولائم
ولیمه	ولایم
وهم	اوهام
وکیل	وکلا
وکیل	وکلاء
پاکت	پاکات
پروانه	پروانجات
پله	پلکان
پیکر	پیکران
چرکس	چراکسه
کائن	کائنات
کاین	کاینات
کاتب	کتاب
کارخانه	کارخانجات
کارنده	کارندگان
کاسب	کسبه
کاعب	کواعب
کافر	کفار
کافر	کفره
کاهن	کهان
کاهن	کهنه
کبیر	کبار
کبیر	کبرا
کبیر	کبراء
کبیره	کبا
کبیره	کبائر
کتاب	کتب
کتف	اکتاف
کتیبه	کتا
کتیبه	کتائب
کثافت	کثافات
کثرت	کثرات
کرامت	کرامات
کرت	کرات
کرد	اکراد
کردوس	کرادیس
کره	کرات
کروبی	کروبیون
کس	کسان
کسر	کسور
کسر	کسورات
کسری	اکاسر
کسری	اکاسره
کشته	کشتگان
کشفیه	کشفیات
کشنده	کشندگان
کشیش	کشیشان
کعب	کعاب
کعب	کعوب
کف	کفوف
کفاره	کفارات
کفن	اکفان
کفو	اکفا
کفو	اکفاء
کلب	کلاب
کلبی	کلبیون
کلف	اسلاک
کلمه	کلمات
کلوخ	کلوخ‌اندازان
کلوخ‌انداز	کلوخ
کم	اکمام
کنایت	کنایات
کنایه	کنایات
کنز	کنوز
کنف	اکناف
کنیس	کنایس
کنیسه	کنایس
کهف	کهوف
کوب	اکواب
کوره	کور
کون	اکوان
کوکب	کواکب
کی	کیان
کیس	اکیاس
کیفیت	کیفیات
کیل	اکیال
گرداننده	گردانندگان
گمرک	گمرکات
گیرنده	گیرندگان
گیسو	گیسوان
یاقوت	یواقیت
یتیم	ایتام
ید	ایادی
ید	ایدی
یعقوبی	یعقوبیان
یم	یموم
یمین	ایمان
ینبوع	ینابیع
یوم	ایام